111111
1E0C01
110001
100111
100001
10C1P1
111111
