1111111111111111111111111111
1000000000000000000000000001
1000000000000000000000000001
1011011010011010001000111001
101C1C10101010101010010E1001
101010101100101C1C1011C11001
1010001010001011111010001001
1P00000000000000000000000001
1111111111111111111111111111
